# Majors
REP = "countries/GalaticRepublic.txt"
CIS = "countries/ConfederacyOfIndependentSystems.txt"
HUT = "countries/HuttConsortium.txt"

# Other
ABR = "countries/Abregado-Rae.txt"
ALD = "countries/Alderaan.txt"
ALZ = "countries/AlocIII.txt"
ANA = "countries/Anaxes.txt"
ATZ = "countries/Atzerri.txt"
BAK = "countries/Bakura.txt"
BES = "countries/Bespin.txt"
BTN = "countries/Bestine.txt"
BOT = "countries/Bothawui.txt"
BOZ = "countries/BozPity.txt"
BRN = "countries/Brentaal.txt"
BYS = "countries/Byss.txt"
CAR = "countries/Carida.txt"
CAT = "countries/CatoNeimoidia.txt" # Secondary Trade Federation Planet
CHR = "countries/Christophsis.txt"
CLA = "countries/Corellia.txt"
COR = "countries/Coruscant.txt"
DAG = "countries/Dagobah.txt"
DAN = "countries/Dantooine.txt"
DAT = "countries/Dathomir.txt"
DUR = "countries/Duro.txt"
END = "countries/Endor.txt" # Not the moon (Forest Moon will be added too)
ERI = "countries/Eriadu.txt"
FEL = "countries/Felucia.txt"
FON = "countries/Fondor.txt"
FRE = "countries/Fresia.txt"
GEO = "countries/Geonosis.txt"
HON = "countries/Honoghr.txt"
HOT = "countries/Hoth.txt" # Sparcely populated, could be cool to have it as a place for fallen empires to hide?
HYP = "countries/Hypori.txt"
ILL = "countries/Illum.txt" # Vast Kiber Crystal Reserves, would eventually become StarKiller Base
ITH = "countries/Ithor.txt"
JAB = "countries/Jabiim.txt"
KAM = "countries/Kamino.txt"
KYK = "countries/Kashyyyk.txt"
KES = "countries/Kessel.txt"
KOR = "countries/Korriban.txt"
KUA = "countries/Kuat.txt"
MAL = "countries/Malastare.txt"
MAN = "countries/Mandalore.txt" # Includes it's moon
MIM = "countries/Mimban.txt"
CAL = "countries/MonCalamari.txt"
MUS = "countries/Mustafar.txt"
MUN = "countries/Muunilinst.txt"
MYG = "countries/Mygeeto.txt"
NAB = "countries/Naboo.txt"
NEI = "countries/Neimoidia.txt" # Primary Trade Federation Homeworld
NIM = "countries/Nimban.txt"
OND = "countries/Onderon.txt"
ORD = "countries/OrdMantell.txt" # Junk Planet
POL = "countries/PolisMassa.txt"
RAK = "countries/RakataPrime.txt" # Ancient home of a galaxy-spanning empire
RAT = "countries/Rattatak.txt"
RAX = "countries/Raxus.txt"
REN = "countries/Rendili.txt"
RHE = "countries/RhenVar.txt"
RIS = "countries/Rishi.txt"
ROC = "countries/Roche.txt" # Asteroids
ROD = "countries/Rodia.txt"
ROT = "countries/Rothana.txt"
RUS = "countries/Ruusan.txt" # Where the Ruusan Reformations were signed
RYL = "countries/Ryloth.txt"
SAL = "countries/Saleucami.txt"
SLU = "countries/SluisVan.txt"
SUL = "countries/Sullust.txt" # Mining World, owned by a corporation
TAR = "countries/Taris.txt"
TAT = "countries/Tatooine.txt"
TET = "countries/Teth.txt"
THY = "countries/Thyferra.txt"
TRO = "countries/Troydaria.txt"
TRA = "countries/Transdosha.txt"
UMB = "countries/Umbara.txt"
UTU = "countries/Utupau.txt"
VER = "countries/Vergesso.txt" # Asteroids
YAV = "countries/Yavin.txt" # Not Yavin 4 (the moon will be added too)

# Gandalf's Ghost Nations for UI/Interface Purposes
ZAA = "countries/ZAA.txt"
ZBA = "countries/ZBA.txt"
ZBB = "countries/ZBB.txt"
ZCB = "countries/ZCB.txt"
ZCC = "countries/ZCC.txt"
ZDC = "countries/ZDC.txt"
ZDD = "countries/ZDD.txt"
ZED = "countries/ZED.txt"
ZEE = "countries/ZEE.txt"
ZFE = "countries/ZFE.txt"
ZFF = "countries/ZFF.txt"
ZGF = "countries/ZGF.txt"
ZGG = "countries/ZGG.txt"

# Gandalf's Event-Based Nations
ALK = "countries/AlkharaBandits.txt"

# I'm sick and tired of errors
# Weiner - PTS